PCON25NM,Fatal,Serious,Slight,Total,Slight_Proportion,Serious_Proportion,Fatal_Proportion
Aberafan Maesteg,3,6,44,53,1.0815157157920714,0.5186228865474148,4.014686229145411
Aldershot,2,30,105,137,0.9984464098179955,1.003175656460328,1.0354178595849477
Aldridge-Brownhills,2,27,73,102,0.932349443939288,1.2126623376623378,1.3907083015993906
Altrincham and Sale West,2,16,29,47,0.8038151137197359,1.5595468361425808,3.0181329098539966
Alyn and Deeside,2,32,90,124,0.945533351233171,1.1822371177209887,1.143969731960789
Amber Valley,1,19,108,128,1.0991825208085613,0.6800172483766234,0.5541103389185073
Arundel and South Downs,9,52,179,240,0.9716230677764566,0.9925865800865802,2.6597296268088346
Ashfield,1,48,129,178,0.9441168218680276,1.2353713702028308,0.39846136731218496
Ashford,4,45,124,173,0.9337521392781782,1.1916335109976728,1.6399103672039057
Ashton-under-Lyne,1,22,63,86,0.9543290103144098,1.1719269102990033,0.8247223649019643
Aylesbury,2,13,116,131,1.1535667280863386,0.4546198076732428,1.0828415783445637
Banbury,5,22,76,103,0.9612412407790079,0.978502080443828,3.4430156981344138
Bangor Aberconwy,2,22,74,98,0.9836977359314713,1.0284256559766765,1.4474719057463046
Barking,1,30,202,233,1.129409603323246,0.5898500640989911,0.3044039630110254
Barnsley North,4,46,69,119,0.755367259864707,1.7708719851576995,2.384071374170384
Barnsley South,2,57,106,165,0.8369084423305589,1.58258559622196,0.8597105864432597
Barrow and Furness,0,38,107,145,0.9613284677518554,1.2005821764442455,0.0
Basildon and Billericay,0,37,99,136,0.9483143316779743,1.2463474025974026,0.0
Basingstoke,0,23,102,125,1.0630316290130797,0.842935064935065,0.0
Bassetlaw,3,50,106,159,0.8684898929845422,1.4406191292983745,1.3382287430484703
Bath,1,3,37,41,1.1756387575766365,0.33520747545137786,1.7299054483309495
Battersea,2,59,306,367,1.0862039805991959,0.7364821826674688,0.38651838355078433
Beaconsfield,5,27,100,132,0.9869203329369798,0.9370572609208974,2.686595582635187
Beckenham and Penge,1,35,154,190,1.055900869891733,0.8438995215311005,0.37329538621878383
Bedford,1,29,131,161,1.059989217214053,0.825179478906187,0.4405349278358318
Bermondsey and Old Southwark,0,55,259,314,1.074548800714951,0.8024340309372157,0.0
Bethnal Green and Stepney,0,47,345,392,1.146539590866073,0.5492727935329976,0.0
Beverley and Holderness,3,36,85,124,0.8930037206091058,1.3300167574361124,1.7159545979411837
Bexhill and Battle,6,65,148,219,0.8803870148062483,1.3597076439542193,1.9431814625087376
Bexleyheath and Crayford,0,23,138,161,1.116629862408697,0.6544526901669758,0.0
Bicester and Woodstock,1,30,58,89,0.8489732661759009,1.5442142127535385,0.7969227346243699
Birkenhead,1,39,102,142,0.9357672790608096,1.25820834095482,0.4994797421237248
Birmingham Edgbaston,1,40,174,215,1.0543063352044908,0.852310480217457,0.3298889459607857
Birmingham Erdington,3,47,202,252,1.0442557046599854,0.8544243454957742,0.8443586116853443
Birmingham Hall Green and Moseley,1,48,187,236,1.0322517583990003,0.9317631521021352,0.3005344211083429
Birmingham Hodge Hill and Solihull North,1,35,143,179,1.0407323019284038,0.8957592686642966,0.39623532615401635
Birmingham Ladywood,5,79,360,444,1.0562714914676865,0.8151178776178776,0.7987176056482986
Birmingham Northfield,1,26,91,118,1.0046514440033052,1.0094100814439797,0.6010688422166858
Birmingham Perry Barr,1,42,152,195,1.0154651056434647,0.9867132867132868,0.3637237096490714
Birmingham Selly Oak,1,23,99,123,1.0485426756764595,0.8566413261535213,0.5766351494436499
Birmingham Yardley,2,37,143,182,1.023577373874639,0.9313365206222349,0.7794079492480103
Bishop Auckland,7,31,51,89,0.7465109754305335,1.5956880198453234,5.57845914237059
Blackburn,1,69,144,214,0.8766066209563603,1.4771058380871465,0.3314304830914436
Blackley and Middleton South,0,23,58,81,0.9328224776500638,1.300825717492384,0.0
Blackpool North and Fleetwood,3,44,84,131,0.8353414237866589,1.538713195201745,1.6242623675168457
Blackpool South,2,75,167,244,0.8916258942320813,1.408146157121567,0.5813616670620404
Blaenau Gwent and Rhymney,2,18,44,64,0.8956302021403092,1.2884537337662338,2.216441355674029
Blaydon and Consett,3,19,48,70,0.8933038899269578,1.243460111317254,3.0396910020672396
Blyth and Ashington,2,26,89,117,0.9909692368669776,1.018037518037518,1.2124123654969048
Bognor Regis and Littlehampton,1,31,108,140,1.0049668761678274,1.0144016697588125,0.5066151670112066
Bolsover,5,38,123,166,0.9652794292508918,1.0487012987012987,2.136329017517136
Bolton North East,3,29,64,96,0.8684898929845422,1.383894751082251,2.216441355674029
Bolton South and Walkden,1,34,87,122,0.928999434708875,1.2767191824568873,0.5813616670620404
Bolton West,3,23,61,87,0.9134117840009841,1.2111135990446336,2.445728392467894
Bootle,3,24,106,133,1.0382698720642272,0.8266770823161801,1.5998373695090735
Boston and Skegness,9,46,263,318,1.0774190653534652,0.6626847994772523,2.0073431145727056
Bournemouth East,2,22,137,161,1.1085383416666053,0.6259982253771075,0.8810698556716636
Bournemouth West,0,36,170,206,1.075072440344943,0.800592611272223,0.0
Bracknell,0,14,50,64,1.0177615933412605,1.0021306818181819,0.0
Bradford East,4,69,156,229,0.8874525544034187,1.3803521805705212,1.238884251206444
Bradford South,2,57,118,177,0.8684898929845422,1.4752916574950472,0.8014251229555811
Bradford West,2,101,242,345,0.9138024091402575,1.3411537737624695,0.41116593264677637
Braintree,1,37,79,117,0.8796243787920364,1.4487456987456988,0.6062061827484524
"Brecon, Radnor and Cwm Tawe",9,75,107,191,0.7298043341571676,1.7988882844903789,3.3420686410163367
Brent East,0,36,338,374,1.1773379030565851,0.4409681227863046,0.0
Brent West,2,30,236,268,1.1471844108825668,0.5128174064741229,0.5292994282206636
Brentford and Isleworth,1,39,145,185,1.0210624417520968,0.9657599157599158,0.3833844507111834
Brentwood and Ongar,4,42,159,205,1.0104138511064065,0.9385809312638581,1.3839243586647596
Bridgend,1,6,43,50,1.1203519619500595,0.5497402597402598,1.4185224676313786
Bridgwater,1,26,88,115,0.9968753554257355,1.0357425183512141,0.6167488989701646
Bridlington and The Wolds,4,45,119,168,0.9227705112960761,1.2270987940630798,1.6887172233706886
Brigg and Immingham,8,36,115,159,0.9422296008794561,1.0372457730948297,3.5686099814625876
Brighton Kemptown and Peacehaven,0,54,132,186,0.924521498983545,1.3300167574361124,0.0
Brighton Pavilion,1,62,196,259,0.9858533920365075,1.096650453793311,0.2738460362222738
Bristol Central,0,18,130,148,1.1442941157566604,0.5571691821691822,0.0
Bristol East,2,21,187,210,1.1600543570579243,0.45811688311688314,0.6754868893482755
Bristol North East,0,12,113,125,1.1776722948870393,0.43979220779220785,0.0
Bristol North West,1,22,117,140,1.0887141158484797,0.7198979591836735,0.5066151670112066
Bristol South,2,21,131,154,1.1081705452692372,0.6247048406139315,0.9211184854749211
Broadland and Fakenham,5,48,99,152,0.8484917704487139,1.446684894053315,2.3330961638673986
Bromley and Biggin Hill,1,34,140,175,1.0421878715814508,0.8900556586270872,0.40529213360896527
Bromsgrove,4,40,92,136,0.8812618031754914,1.3474025974025976,2.086062452399086
Broxbourne,0,32,144,176,1.0658739595719382,0.8329397874852421,0.0
Broxtowe,4,27,82,113,0.9453474056380415,1.0946155614297208,2.5106592347458028
Buckingham and Bletchley,1,21,59,81,0.9489056238164443,1.1877104377104377,0.8756311528588756
Burnley,3,44,150,197,0.9919300808199085,1.0232052211747644,1.0800932494655167
Burton and Uttoxeter,6,25,49,80,0.7979250891795482,1.4316152597402598,5.319459253617669
Bury North,1,13,62,76,1.062757369046874,0.783620984278879,0.9332384655469594
Bury South,3,27,66,96,0.8956302021403092,1.2884537337662338,2.216441355674029
Bury St Edmunds and Stowmarket,4,30,74,108,0.8926146122341129,1.2725468975468976,2.626893458576627
Caerfyrddin,2,65,102,169,0.7862659977907394,1.7619880119880122,0.8393624068824724
Caerphilly,7,21,52,80,0.8467776456599286,1.2025568181818183,6.2060357958872805
Calder Valley,6,57,113,176,0.8364149821640904,1.4836739964580874,2.417936024371668
Camborne and Redruth,2,39,112,153,0.9536359609242031,1.1677489177489178,0.9271388677329272
Cambridge,0,36,102,138,0.9628909683089489,1.1950875211744778,0.0
Cannock Chase,3,14,44,61,0.9396775891308162,1.0514157973174367,3.488170002372242
Canterbury,4,44,158,206,0.9991849739676529,0.978502080443828,1.3772062792537654
Cardiff East,1,11,80,92,1.1328129038928811,0.547748447204969,0.7709361237127057
Cardiff North,0,4,41,45,1.1869361870788744,0.40721500721500725,0.0
Cardiff South and Penarth,1,11,64,76,1.0970398648225796,0.6630639097744362,0.9332384655469594
Cardiff West,2,14,68,84,1.0545948700526584,0.7635281385281385,1.6887172233706886
Carlisle,3,47,122,172,0.9240328512568095,1.2518310178193899,1.2370835473529465
Carshalton and Wallington,1,29,156,186,1.0926163169805532,0.7142682586230974,0.38132324398692974
Castle Point,3,26,80,109,0.9561356620013309,1.0927558679852258,1.952095138942264
Central Devon,3,39,134,176,0.9918549346016646,1.0151453659976388,1.208968012185834
Central Suffolk and North Ipswich,2,35,65,102,0.8301741624116947,1.571969696969697,1.3907083015993906
Ceredigion Preseli,1,63,110,174,0.8235680019681004,1.6586990595611286,0.407621398744649
Chatham and Aylesford,2,37,128,167,0.9985033500181564,1.0149895015164476,0.8494146512762746
Cheadle,2,14,50,66,0.9869203329369798,0.9717630853994491,2.1492764661081494
Chelmsford,0,30,110,140,1.023577373874639,0.9816790352504638,0.0
Chelsea and Fulham,1,83,387,471,1.0703999636465538,0.8072972674883503,0.15058624921776842
Cheltenham,1,32,94,127,0.9642289363056729,1.1543102566724615,0.5584734124532986
Chesham and Amersham,0,26,58,84,0.8995073891625616,1.4179808286951145,0.0
Chester North and Neston,3,19,88,110,1.0421878715814508,0.79129279811098,1.9343488194973342
Chester South and Eddisbury,4,34,101,139,0.9465915020658859,1.1205736709333833,2.0410395217717676
Chesterfield,0,30,121,151,1.0439133481900291,0.9101659929474499,0.0
Chichester,3,54,161,218,0.9621115098888392,1.1347849398308114,0.976047569471132
Chingford and Woodford Green,5,24,190,219,1.1302265730620753,0.5020458993061733,1.619317885423948
Chippenham,6,17,94,117,1.0466416659044484,0.6656399156399158,3.637237096490714
Chipping Barnet,3,32,172,207,1.0824656637198642,0.7082000125478386,1.0279148316169409
Chorley,1,47,89,137,0.8463021949885867,1.5716418617878474,0.5177089297924738
Christchurch,4,24,111,139,1.0403134329634984,0.7909931794823882,2.0410395217717676
Cities of London and Westminster,1,211,766,978,1.0203424202855205,0.9883707805486948,0.07252159854966149
City of Durham,4,24,45,73,0.8030557229651589,1.50613769791852,3.886362925017475
Clacton,1,33,105,139,0.9840802744249308,1.0876156217882837,0.5102598804429419
Clapham and Brixton Hill,5,54,271,330,1.069821640903686,0.7496458087367178,1.0746382330540747
Clwyd East,3,32,87,122,0.928999434708875,1.2016180540770707,1.744085001186121
Clwyd North,3,33,84,120,0.9119143876337693,1.2598214285714286,1.7731530845392232
Colchester,0,29,114,143,1.0385438580444526,0.9290482245027699,0.0
Colne Valley,2,41,83,126,0.8581507275918691,1.490697794269223,1.1258114822471257
Congleton,1,15,60,76,1.0284748732711684,0.904178058783322,0.9332384655469594
Corby and East Northamptonshire,5,20,98,123,1.0379513355181114,0.744905501003062,2.883175747218249
Coventry East,1,20,100,121,1.076640363203978,0.7572179886229473,0.5861663089385861
Coventry North West,0,35,61,96,0.8277794292508918,1.670217803030303,0.0
Coventry South,2,25,95,122,1.0144246700844037,0.9387641047477113,1.1627233341240808
Cramlington and Killingworth,2,19,97,118,1.0708921985529738,0.7376458287475236,1.2021376844333715
Crawley,1,61,182,244,0.9717120523966395,1.1452922077922079,0.2906808335310202
Crewe and Nantwich,2,23,105,130,1.0522089088081954,0.8105144855144856,1.0911711289472144
Croydon East,1,30,148,179,1.077121543254572,0.7677936588551113,0.39623532615401635
Croydon South,2,28,143,173,1.076827063844996,0.7414608512874409,0.8199551836019529
Croydon West,1,54,395,450,1.1435116924296471,0.5497402597402598,0.1576136075145976
Dagenham and Rainham,2,35,185,222,1.0856123662306778,0.7222563472563472,0.6389740845186389
Darlington,1,23,52,76,0.891344890168346,1.3864063568010936,0.9332384655469594
Dartford,0,51,242,293,1.0759789459160027,0.7974048136164178,0.0
Daventry,7,41,166,214,1.0105326324913597,0.8777005704575798,2.3200133816401047
Derby North,4,40,147,191,1.00262838430938,0.9594070850615354,1.4853638404517053
Derby South,1,40,178,219,1.0588438421318391,0.8367431655102888,0.3238635770847896
Derbyshire Dales,8,73,150,231,0.8459317139459827,1.4477286782481589,2.4563159612664562
Dewsbury and Batley,1,49,125,175,0.930524885340581,1.282727272727273,0.40529213360896527
Didcot and Wantage,3,15,62,80,1.0096195005945303,0.8589691558441559,2.6597296268088346
Doncaster Central,1,67,157,225,0.9090194213238209,1.3641702741702741,0.3152272150291952
Doncaster East and the Isle of Axholme,2,39,102,143,0.9292234519345103,1.249409681227863,0.9919737535883766
Doncaster North,2,62,98,162,0.7880741621526401,1.75328683662017,0.8756311528588756
Dorking and Horley,2,60,130,192,0.8820600475624257,1.4316152597402598,0.7388137852246762
Dover and Deal,5,43,149,197,0.9853172136144426,0.9999505570571561,1.800155415775861
Droitwich and Evesham,5,39,54,98,0.7178334829770195,1.82311820832229,3.6186797643657616
Dudley,2,31,112,145,1.0062503587682972,0.979422301836095,0.9782913569871575
Dulwich and West Norwood,1,48,241,290,1.0826175734962482,0.7582624272279445,0.24457283924678938
Dunstable and Leighton Buzzard,0,20,119,139,1.1152909776815885,0.6591609829019901,0.0
Dwyfor Meirionnydd,9,47,69,125,0.719109631391201,1.7225194805194806,5.106680883472962
Ealing Central and Acton,3,43,313,359,1.1358105982068039,0.548719386463119,0.592697409873835
Ealing North,1,38,230,269,1.113862502154896,0.6471539612803554,0.2636658861768361
Ealing Southall,1,30,210,241,1.135163138133323,0.5702699789836719,0.2942992671434395
Earley and Woodley,0,12,64,76,1.0970398648225796,0.7233424470266575,0.0
Easington,1,19,45,65,0.9018933504070246,1.3391108891108892,1.0911711289472144
East Grinstead and Uckfield,0,54,121,175,0.9007480890096823,1.4136178107606678,0.0
East Ham,0,31,264,295,1.1658372800741652,0.4814109619194365,0.0
East Hampshire,5,46,124,175,0.9230806862578562,1.2041929499072357,2.0264606680448263
East Surrey,1,54,212,267,1.034381220857994,0.9265285276521231,0.26564091154145664
East Thanet,3,40,148,191,1.0094489855631852,0.9594070850615354,1.1140228803387788
East Wiltshire,5,29,166,200,1.081269916765755,0.6642694805194805,1.7731530845392232
East Worthing and Shoreham,3,63,143,209,0.891344890168346,1.3809264897781646,1.0180783260512287
Eastbourne,2,34,121,157,1.0040185705521938,0.9921002564314667,0.9035174953066105
Eastleigh,3,21,79,103,0.9991849739676529,0.9340247131509267,2.065809418880648
Edmonton and Winchmore Hill,6,29,356,391,1.1861217464290168,0.33977978543195936,1.0883804099473493
Ellesmere Port and Bromborough,1,11,74,86,1.1209578851312114,0.5859634551495017,0.8247223649019643
Eltham and Chislehurst,0,45,179,224,1.041024715474775,0.9203240955473099,0.0
Ely and East Cambridgeshire,8,44,118,170,0.9042512415191998,1.185714285714286,3.3376999238385374
Enfield North,3,29,338,370,1.1900658803869268,0.3590645840645841,0.5750766760667751
Epping Forest,7,50,161,218,0.9621115098888392,1.0507267961396403,2.277444328765975
Epsom and Ewell,1,52,184,237,1.0114059513237705,1.0051509671762837,0.29926634338214736
Erewash,2,37,96,135,0.9263892191835117,1.2555796055796056,1.0507573834306507
Erith and Thamesmead,3,23,152,178,1.1124477280925595,0.5919487815555232,1.195384101936555
Esher and Walton,0,39,127,166,0.9966706302021403,1.0762987012987013,0.0
Exeter,0,22,78,100,1.0161331747919145,1.007857142857143,0.0
Exmouth and Exeter East,1,22,82,105,1.017373874639035,0.9598639455782314,0.6754868893482755
Fareham and Waterlooville,2,32,96,130,0.9620195737674929,1.1276723276723277,1.0911711289472144
Farnham and Bordon,2,45,134,181,0.9644556270159833,1.1389646265336875,0.7837140705145738
Faversham and Mid Kent,4,50,188,242,1.0120419414117392,0.9465224857786841,1.1723326178771722
Feltham and Heston,2,51,281,334,1.096013442793367,0.6995197915856599,0.4247073256381373
Filton and Bradley Stoke,2,15,75,92,1.062012097399576,0.7469297007340486,1.5418722474254114
Finchley and Golders Green,0,60,279,339,1.0721623015163153,0.8108263417997932,0.0
Folkestone and Hythe,2,32,150,184,1.062012097399576,0.7967250141163185,0.7709361237127057
Forest of Dean,3,53,99,155,0.8320693490851904,1.56646418098031,1.372763678352947
Frome and East Somerset,6,21,86,113,0.9914619132301411,0.8513676588897828,3.7659888521187037
Fylde,1,54,139,194,0.9334027973570982,1.2751707055830768,0.3655985741317986
Gainsborough,6,62,132,200,0.8598049940546968,1.4201623376623378,2.1277837014470675
Gateshead Central and Whickham,1,41,103,145,0.9253909549387018,1.2953649798477385,0.48914567849357876
Gedling,2,22,81,105,1.0049668761678274,0.9598639455782314,1.350973778696551
Gillingham and Rainham,2,33,140,175,1.0421878715814508,0.8638775510204083,0.8105842672179305
Glastonbury and Somerton,4,29,117,150,1.0161331747919145,0.8856926406926408,1.8913632901751714
Gloucester,0,38,116,154,0.9812807881773399,1.1304182830156857,0.0
Godalming and Ash,4,60,139,203,0.892020407326488,1.3540400486213295,1.3975590814102252
Goole and Pocklington,2,37,125,164,0.9929381398451321,1.0335563826417486,0.8649527241654748
Gorton and Denton,1,29,57,87,0.853515929312395,1.527056277056277,0.815242797489298
Gosport,2,35,82,119,0.8976828305638546,1.3474025974025976,1.192035687085192
Gower,0,14,38,52,0.9519985365407482,1.2333916083916083,0.0
Grantham and Bourne,6,49,168,223,0.9814325248076441,1.0066245413779047,1.9083261896386259
Gravesham,0,32,174,206,1.1003682624707063,0.7116378766864203,0.0
Great Grimsby and Cleethorpes,2,62,191,255,0.975773938588515,1.1138528138528139,0.5562833206397563
Great Yarmouth,2,35,105,142,0.9632898460920098,1.1291613316261204,0.9989594842474496
Greenwich and Woolwich,0,33,169,202,1.0899118211464427,0.7484087694483734,0.0
Guildford,2,70,190,262,0.9447313721396737,1.2239764052741153,0.5414207891722819
Hackney North and Stoke Newington,1,37,234,272,1.120735119255788,0.6231737012987013,0.26075780654988573
Hackney South and Shoreditch,2,57,310,369,1.0944384830293012,0.7076602259529089,0.3844234329624332
Halesowen,1,19,89,109,1.0637009239764805,0.7985523650661266,0.6506983796474214
Halifax,4,45,108,157,0.8961488067738588,1.3130738688063528,1.807034990613221
Hamble Valley,0,39,109,148,0.9594466047498152,1.2071998946998945,0.0
Hammersmith and Chiswick,0,72,267,339,1.0260477939242159,0.9729916101597518,0.0
Hampstead and Highgate,2,35,292,329,1.1562266660402112,0.4873583862945565,0.4311618442648567
"Harborough, Oadby and Wigston",1,14,65,80,1.0584720570749109,0.8017045454545454,0.8865765422696116
Harlow,3,34,105,142,0.9632898460920098,1.0968995792939455,1.4984392263711745
Harpenden and Berkhamsted,2,33,130,165,1.026397146254459,0.9162337662337663,0.8597105864432597
Harrogate and Knaresborough,4,19,86,109,1.0278458366514307,0.7985523650661266,2.6027935185896856
Harrow East,1,19,156,176,1.1546967895362663,0.49455799881936247,0.402989337395278
Harrow West,0,26,145,171,1.104658197217181,0.6965519860256703,0.0
Hartlepool,1,25,63,89,0.922160616708306,1.2868451772946157,0.7969227346243699
Harwich and North Essex,3,40,90,133,0.8815498913752872,1.3777951371936334,1.5998373695090735
Hastings and Rye,1,58,150,209,0.9349771575192439,1.27132914931958,0.3393594420170762
Havant,0,27,115,142,1.0550317361960109,0.8710673129687214,0.0
Hayes and Harlington,5,42,268,315,1.1083585300945586,0.6108225108225108,1.1258114822471257
Hazel Grove,1,15,45,61,0.9610338979746984,1.1265169256972536,1.1627233341240808
Hemel Hempstead,2,24,72,98,0.9571113106360262,1.1219188974291014,1.4474719057463046
Hendon,0,31,187,218,1.1174835549640554,0.651450613606577,0.0
Henley and Thame,4,33,76,113,0.8761756442498922,1.3378634639696587,2.5106592347458028
Hereford and South Herefordshire,5,24,121,150,1.0508727705112961,0.7329870129870131,2.364204112718964
Herne Bay and Sandwich,0,29,134,163,1.0709599293858465,0.815054577324516,0.0
Hertford and Stortford,2,13,75,90,1.0856123662306778,0.6617243867243867,1.576136075145976
Hertsmere,5,40,154,199,1.0081465591931118,0.9208379560138354,1.782063401546958
Hexham,9,41,68,118,0.7507285515629094,1.5917620515078144,5.4096195799501725
Heywood and Middleton North,1,27,52,80,0.8467776456599286,1.5461444805194806,0.8865765422696116
High Peak,1,46,86,133,0.8423698962030521,1.5844644077726784,0.5332791231696912
Hinckley and Bosworth,3,26,68,97,0.9132574132414774,1.2279421609318517,2.1935914447907914
Hitchin,2,34,83,119,0.9086301821560966,1.3089053803339517,1.192035687085192
Holborn and St Pancras,1,55,305,361,1.1006485485884434,0.69796201028888,0.19647125590462305
Honiton and Sidmouth,6,35,105,146,0.936898343459352,1.098225404732254,2.914772193763106
Hornchurch and Upminster,1,21,165,187,1.1494719171854235,0.5144628099173554,0.37928408225437926
Hornsey and Friern Barnet,0,26,320,346,1.204841470036359,0.3442496809548833,0.0
Horsham,3,36,120,159,0.9831961052655196,1.0372457730948297,1.3382287430484703
Houghton and Sunderland South,2,31,80,113,0.9222901518419917,1.2567808297896794,1.2553296173729014
Hove and Portslade,2,41,133,176,0.9844530321046374,1.0672041027154664,0.805978674790556
Huddersfield,0,48,149,197,0.9853172136144426,1.1162238776451976,0.0
Huntingdon,3,48,133,184,0.9416507263609575,1.1950875211744778,1.1564041855690586
Hyndburn,4,56,126,186,0.8824977944842928,1.3792766373411536,1.525292975947719
Ilford North,3,28,194,225,1.123246928260008,0.5701010101010101,0.9456816450875857
Ilford South,1,36,211,248,1.1083752061677727,0.6650083787180562,0.2859924329901973
Ipswich,0,34,129,163,1.0309987379908523,0.9555812285873635,0.0
Isle of Wight East,1,26,67,94,0.9285450451590052,1.267131804365847,0.7545332274634992
Isle of Wight West,3,47,89,139,0.834125184988751,1.5490283098196769,1.5307796413288257
Islington North,0,31,176,207,1.1076392838063727,0.6860687621557187,0.0
Islington South and Finsbury,1,73,315,389,1.054913816028782,0.8597052048208861,0.18232936601945737
Jarrow and Gateshead East,1,18,66,85,1.0115352871231726,0.9701298701298702,0.8344249809596344
Keighley and Ilkley,3,38,100,141,0.9239254180686619,1.2346412452795432,1.5090664549269983
Kenilworth and Southam,7,54,113,174,0.8460289474763213,1.421742051052396,2.8533497912125427
Kensington and Bayswater,3,94,397,494,1.046934678688856,0.8717203848782796,0.4307254456370583
Kettering,4,34,109,147,0.9659734524011746,1.0595900697941516,1.9299625409950727
Kingston and Surbiton,2,36,153,191,1.0435519918322118,0.8634663765553818,0.7426819202258527
Kingston upon Hull East,2,48,180,230,1.019531613503593,0.9560700169395822,0.6167488989701646
Kingston upon Hull North and Cottingham,2,54,217,273,1.0355071800969542,0.9061652633081204,0.5196052994986734
Kingston upon Hull West and Haltemprice,4,34,199,237,1.0938575234425563,0.6572140939229547,1.1970653735285894
Kingswinford and South Staffordshire,2,13,64,79,1.0553801231204563,0.7538632253822127,1.795598060292884
Knowsley,3,24,102,129,1.0300694079584105,0.852310480217457,1.6494447298039285
Lancaster and Wyre,4,63,117,184,0.8283694359716693,1.5685523715415022,1.5418722474254114
Leeds Central and Headingley,2,67,187,256,0.9516070897740785,1.1989777800324677,0.5541103389185073
Leeds East,0,51,135,186,0.945533351233171,1.2561269375785504,0.0
Leeds North East,2,43,92,137,0.8748292352691008,1.437885107593137,1.0354178595849477
Leeds North West,0,41,101,142,0.9265930900504096,1.3227318456191697,0.0
Leeds South,2,81,184,267,0.8977648331975043,1.389792791478185,0.5312818230829133
Leeds South West and Morley,0,58,124,182,0.8875775829402465,1.4599329242186385,0.0
Leeds West and Pudsey,5,41,90,136,0.8621039378890676,1.3810876623376622,2.6075780654988576
Leicester East,1,31,91,123,0.9638119544096749,1.154603526554746,0.5766351494436499
Leicester South,0,28,109,137,1.0364824635253478,0.9362972793629728,0.0
Leicester West,3,26,119,148,1.047469229038789,0.8047999297999299,1.4376916901669377
Leigh and Atherton,2,14,71,87,1.0631514207224568,0.7371995820271683,1.630485594978596
Lewes,1,57,150,208,0.9394722400073173,1.2554164585414587,0.34099097779600446
Lewisham East,0,32,223,255,1.1392543890326643,0.5748917748917749,0.0
Lewisham North,1,40,278,319,1.1352987002337118,0.5744412327484427,0.22233894476980853
Lewisham West and East Dulwich,0,41,201,242,1.0820235650199979,0.776148438338521,0.0
Leyton and Wanstead,0,32,172,204,1.098384276421627,0.7186147186147186,0.0
Lichfield,5,13,36,54,0.8684898929845422,1.1028739778739778,6.567233646441567
Lincoln,4,25,148,177,1.0892924081501036,0.6470577445153717,1.6028502459111622
Liverpool Garston,2,33,99,134,0.9624682769268994,1.1281982942430704,1.0585988564413271
Liverpool Riverside,2,55,202,259,1.0160325775070127,0.9728350799779372,0.5476920724445477
Liverpool Walton,1,33,118,152,1.0113336253833156,0.9945958646616542,0.4666192327734797
Liverpool Wavertree,0,32,135,167,1.0531090019722742,0.8778287580682791,0.0
Liverpool West Derby,2,36,126,164,1.000881644963893,1.0056224263541338,0.8649527241654748
Llanelli,1,49,101,151,0.8713656873321731,1.4866044551475015,0.4697094263680061
Loughborough,0,11,76,87,1.1380212390831932,0.5792282430213466,0.0
Louth and Horncastle,11,52,172,235,0.953491031446859,1.0137054434926775,3.3199462008393965
Lowestoft,0,26,77,103,0.9738891518418895,1.1564115496154332,0.0
Luton North,3,25,143,171,1.0894215324279783,0.6697615250246829,1.2443179540626126
Luton South and South Bedfordshire,3,40,191,234,1.0633433946156894,0.7831057831057832,0.9093092741226785
Macclesfield,2,17,80,99,1.052715021799445,0.786665354847173,1.432850977405433
Maidenhead,0,28,78,106,0.9586162026338815,1.2101200686106346,0.0
Maidstone and Malling,2,23,119,144,1.0765655965120886,0.7317144660894661,0.985085046966235
Makerfield,1,14,37,52,0.9269459434738864,1.2333916083916083,1.3639639111840178
Maldon,2,49,108,159,0.8848764947389675,1.4118067467124071,0.8921524953656469
Manchester Central,2,43,143,188,0.9909100108786398,1.0478205305332966,0.7545332274634992
Manchester Rusholme,3,34,95,132,0.9375743162901308,1.1799980322707595,1.611957349581112
Manchester Withington,1,19,31,51,0.7918584318388472,1.7067099567099568,1.3907083015993906
Mansfield,2,34,132,168,1.023577373874639,0.9271413110698825,0.8443586116853443
Melksham and Devizes,2,17,109,128,1.1093601367419739,0.6084364853896104,1.1082206778370145
Melton and Syston,3,29,59,91,0.844630280539912,1.4599329242186385,2.3382238477440307
Meriden and Solihull East,0,40,93,133,0.9109348877544634,1.3777951371936334,0.0
Merthyr Tydfil and Aberdare,1,15,68,84,1.0545948700526584,0.81806586270872,0.8443586116853443
Mid Bedfordshire,1,38,131,170,1.0038721410086033,1.024025974025974,0.4172124904798172
Mid Buckinghamshire,1,31,90,122,0.9610338979746984,1.1640674898871621,0.5813616670620404
Mid Cheshire,1,19,73,93,1.0225768094817997,0.9359377181957829,0.7626464879738595
Mid Derbyshire,1,25,83,109,0.9919907493263808,1.0507267961396403,0.6506983796474214
Mid Dorset and North Poole,2,27,140,169,1.079188624418662,0.7319027126719435,0.8393624068824724
Mid Leicestershire,6,12,60,78,1.0021037226744718,0.7047952047952049,5.455855644736071
Mid Norfolk,5,30,91,126,0.9408640507332541,1.0907544836116265,2.8145287056178145
Mid Sussex,4,44,111,159,0.9094563973706055,1.2677448337825696,1.7843049907312938
Mid and South Pembrokeshire,2,54,95,151,0.8196013890748163,1.6382987873054098,0.9394188527360122
Middlesbrough South and East Cleveland,1,15,39,55,0.9237574316290131,1.249409681227863,1.2895658796648894
Middlesbrough and Thornaby East,1,25,103,129,1.0401681276442774,0.8878234168931844,0.5498149099346428
Milton Keynes Central,4,26,126,156,1.0522089088081954,0.7635281385281385,1.818618548245357
Milton Keynes North,0,24,47,71,0.8623737669776088,1.5485641119443936,0.0
Mitcham and Morden,0,50,206,256,1.0482944411414983,0.8947595373376623,0.0
Monmouthshire,3,31,47,81,0.7559078698198793,1.75328683662017,2.626893458576627
Montgomeryshire and Glyndwr,4,62,125,191,0.8525751567256631,1.4870809818453798,1.4853638404517053
Morecambe and Lunesdale,6,59,97,162,0.7800325890694499,1.6684503767837102,2.626893458576627
Neath and Swansea East,2,8,40,50,1.0421878715814508,0.7329870129870131,2.837044935262757
New Forest East,3,42,137,182,0.9806300714743045,1.0571928071928074,1.1691119238720153
New Forest West,2,41,90,133,0.8815498913752872,1.4122400156234742,1.0665582463393823
Newark,7,59,175,241,0.945969281777769,1.121530958667888,2.0600948700040767
Newbury,2,18,67,87,1.0032555660338676,0.9478280340349307,1.630485594978596
Newcastle upon Tyne Central and West,4,53,192,249,1.0045184304399524,0.9751082251082251,1.1393754760091392
Newcastle upon Tyne East and Wallsend,0,37,115,152,0.9856217535515364,1.115152939166097,0.0
Newcastle upon Tyne North,0,12,84,96,1.1398929845422117,0.5726461038961039,0.0
Newcastle-under-Lyme,3,16,42,61,0.8969649714430518,1.2016180540770707,3.488170002372242
Newport East,3,25,67,95,0.9187708867889104,1.2055707450444293,2.239772317312703
Newport West and Islwyn,4,27,43,74,0.7569945688851752,1.6715075465075466,3.833844507111834
Newton Abbot,0,20,81,101,1.0447675445309097,0.9071621447859073,0.0
Newton Aycliffe and Spennymoor,3,28,44,75,0.7642711058263971,1.7103030303030304,2.837044935262757
Normanton and Hemsworth,1,51,118,170,0.9042512415191998,1.3743506493506494,0.4172124904798172
North Bedfordshire,2,32,111,145,0.9972659805650088,1.0110165696372593,0.9782913569871575
North Cornwall,6,43,152,201,0.985152714430227,0.9800510434838793,2.1171977128826542
North Cotswolds,5,62,104,171,0.7923065690385297,1.6610085820612137,2.073863256771021
North Devon,4,30,119,153,1.013238208481966,0.8982683982683983,1.8542777354658544
North Dorset,1,19,91,111,1.0680078413728828,0.7841640341640342,0.6389740845186389
North Durham,4,30,54,88,0.7994054696789537,1.5617621015348289,3.223914699162224
North East Cambridgeshire,4,26,119,149,1.0404392342130253,0.799398587989192,1.9040570035320517
North East Derbyshire,5,34,71,110,0.8408561236623069,1.4159976387249116,3.223914699162224
North East Hampshire,2,32,122,156,1.018805451385713,0.9397269397269398,0.9093092741226785
North East Hertfordshire,2,31,93,126,0.9615423815186004,1.1271129663986807,1.1258114822471257
North East Somerset and Hanham,0,10,35,45,1.013238208481966,1.018037518037518,0.0
North Herefordshire,2,41,107,150,0.9292841854934603,1.252186147186147,0.9456816450875857
North Norfolk,1,39,90,130,0.9018933504070246,1.3743506493506494,0.5455855644736072
North Northumberland,3,45,66,114,0.7542149070655235,1.808356117566644,1.8664769310939189
North Shropshire,6,31,59,96,0.800639120095125,1.4793357683982686,4.432882711348058
North Somerset,3,18,81,102,1.034524725466881,0.8084415584415585,2.086062452399086
North Warwickshire and Bedworth,6,54,164,224,0.9537880074740954,1.1043889146567718,1.8998068762920246
North West Cambridgeshire,0,29,126,155,1.0589973533811514,0.8571219103477169,0.0
North West Essex,4,54,117,175,0.8709712926787838,1.4136178107606678,1.621168534435861
North West Hampshire,3,24,85,112,0.9886826906743672,0.9816790352504638,1.8998068762920246
North West Leicestershire,6,29,52,87,0.7786461109516586,1.527056277056277,4.891456784935788
North West Norfolk,4,53,112,169,0.8633508995349296,1.4366979174671484,1.6787248137649449
Northampton North,1,33,204,238,1.116629862408697,0.6352040816326531,0.298008921771298
Northampton South,1,21,116,138,1.0950524737631184,0.6971343873517787,0.5139574158084704
Norwich North,1,18,73,92,1.033691774802254,0.8963156408808584,0.7709361237127057
Norwich South,2,36,106,144,0.958957590170432,1.1452922077922079,0.985085046966235
Nottingham East,3,54,200,257,1.0138014314994657,0.9625802213350853,0.8279314013412715
Nottingham North and Kimberley,0,55,148,203,0.9497771243476274,1.2412033779028853,0.0
Nottingham South,1,38,149,188,1.0324866546917297,0.9259809339596573,0.3772666137317496
Nuneaton,1,29,118,148,1.0386669666098916,0.8976614601614602,0.47923056338897924
Old Bexley and Sidcup,1,28,127,156,1.0605597731638159,0.8222610722610723,0.45465463706133924
Oldham East and Saddleworth,1,31,52,84,0.8064549006285036,1.6906694495980212,0.8443586116853443
"Oldham West, Chadderton and Royton",2,20,77,99,1.013238208481966,0.92548865276138,1.432850977405433
Orpington,2,30,128,160,1.0421878715814508,0.8589691558441559,0.8865765422696116
Ossett and Denby Dale,2,62,123,187,0.8568790655382248,1.5188902007083827,0.7585681645087585
Oxford East,0,32,133,165,1.0500832342449464,0.8884691066509248,0.0
Oxford West and Abingdon,3,21,90,114,1.0284748732711684,0.8438995215311005,1.8664769310939189
Peckham,2,57,241,300,1.0465303210463734,0.8704220779220779,0.47284082254379284
Pendle and Clitheroe,1,46,106,153,0.9025483201604065,1.3773448773448773,0.4635694338664636
Penistone and Stocksbridge,4,52,88,144,0.7961157352358305,1.6543109668109668,1.97017009393247
Penrith and Solway,4,42,102,148,0.8978307677475335,1.300061425061425,1.916922253555917
Peterborough,2,45,162,209,1.0097753301207837,0.9863760641272604,0.6787188840341524
Plymouth Moor View,0,25,117,142,1.073380114216811,0.8065438083043717,0.0
Plymouth Sutton and Devonport,1,38,155,194,1.0408448459737427,0.8973423483732762,0.3655985741317986
"Pontefract, Castleford and Knottingley",2,46,102,150,0.8858596908442331,1.4048917748917749,0.9456816450875857
Pontypridd,6,9,48,63,0.9925598776966196,0.6544526901669758,6.7548688934827545
Poole,2,29,136,167,1.060909809394291,0.7955323119993779,0.8494146512762746
Poplar and Limehouse,2,35,176,213,1.0764381772202778,0.7527742210840803,0.6659729894982998
Portsmouth North,2,59,194,255,0.991100230817654,1.05995670995671,0.5562833206397563
Portsmouth South,0,36,172,208,1.077261501875057,0.7928946053946054,0.0
Preston,1,97,193,291,0.8640131409588486,1.527056277056277,0.24373238275453238
Putney,0,30,205,235,1.1364282642244543,0.5848300635534678,0.0
Queen's Park and Maida Vale,1,52,299,352,1.1065844233055886,0.6767635773317592,0.201494668697639
Rawmarsh and Conisbrough,0,33,101,134,0.9819120805011802,1.1281982942430704,0.0
Rayleigh and Wickford,1,34,65,100,0.8467776456599286,1.5575974025974029,0.7092612338156893
Reading Central,0,23,151,174,1.1305342572471195,0.6055567995223168,0.0
Reading West and Mid Berkshire,3,22,100,125,1.0421878715814508,0.8062857142857143,1.7022269611576542
Redcar,0,24,73,97,0.9804086936268801,1.1334850716294016,0.0
Redditch,2,19,61,82,0.9691076244888489,1.0614903389293635,1.7299054483309495
Reigate,1,53,162,216,0.97705112960761,1.124083092833093,0.32836168232207835
Rhondda and Ogmore,2,12,54,68,1.034524725466881,0.8084415584415585,2.086062452399086
Ribble Valley,1,67,137,205,0.8706081610162119,1.4972600570161547,0.3459810896661899
Richmond Park,2,80,161,243,0.8631288442624154,1.5082037304259528,0.5837541019059171
Richmond and Northallerton,3,46,71,120,0.7707847800237813,1.7561147186147188,1.7731530845392232
Rochdale,3,26,62,91,0.8875775829402465,1.3089053803339517,2.3382238477440307
Rochester and Strood,1,42,135,178,0.9880292321874707,1.080949948927477,0.39846136731218496
Romford,0,17,174,191,1.186784618162123,0.4077480111511525,0.0
Romsey and Southampton North,3,44,145,192,0.9838362068965517,1.0498511904761905,1.1082206778370145
Rossendale and Darwen,2,57,93,152,0.7970680267851554,1.7179383116883118,0.9332384655469594
Rother Valley,6,40,78,124,0.8194622377354148,1.4777963971512358,3.4319091958823673
Rotherham,4,65,134,203,0.8599333423147437,1.4668767193397736,1.3975590814102252
Rugby,2,32,97,131,0.9646204536584038,1.1190641419649052,1.0828415783445637
"Ruislip, Northwood and Pinner",2,21,93,116,1.0444339661322728,0.8293495297805643,1.222864196233947
Runcorn and Helsby,2,28,121,151,1.0439133481900291,0.8494882600842866,0.9394188527360122
Runnymede and Weybridge,1,67,258,326,1.0309987379908523,0.9415285634610788,0.21756479564898443
Rushcliffe,1,43,81,125,0.844172175980975,1.575922077922078,0.5674089870525514
Rutland and Stamford,4,29,88,121,0.9474435196195006,1.0979660835032736,2.3446652357543445
Salford,1,20,62,83,0.9731272294887039,1.103896103896104,0.8545316070068546
Salisbury,1,35,163,199,1.0670642152498522,0.8057332115121061,0.3564126803093916
Scarborough and Whitby,5,32,122,159,0.9995827070199449,0.9219962427509598,2.2303812384141173
Scunthorpe,3,43,178,224,1.0352089349413962,0.8794208024118739,0.9499034381460123
Sefton Central,1,21,80,102,1.021752815275932,0.9431818181818181,0.6953541507996953
Selby,5,35,80,120,0.8684898929845422,1.3361742424242427,2.955255140898705
Sevenoaks,4,44,201,249,1.0516052318668252,0.8095238095238095,1.1393754760091392
Sheffield Brightside and Hillsborough,3,51,134,188,0.9285450451590052,1.2427638850511191,1.1317998411952488
Sheffield Central,2,54,122,178,0.892885676495344,1.389792791478185,0.7969227346243699
Sheffield Hallam,2,35,52,89,0.7611484455370144,1.8015832482124619,1.5938454692487398
Sheffield Heeley,3,43,98,144,0.8865834324217202,1.3679879148629148,1.4776275704493524
Sheffield South East,2,36,78,116,0.8759768748206158,1.421742051052396,1.222864196233947
Sherwood Forest,3,30,95,128,0.9668735136741974,1.0737114448051948,1.6623310167555216
Shipley,1,55,98,154,0.829013079667063,1.63613172541744,0.4605592427374606
Shrewsbury,5,16,62,83,0.9731272294887039,0.8831168831168832,4.272658035034272
Sittingbourne and Sheppey,0,30,153,183,1.0891717510379915,0.7510112837981691,0.0
Skipton and Ripon,9,71,172,252,0.8891682237698885,1.2907261389404248,2.533075835056033
Sleaford and North Hykeham,2,34,160,196,1.0634570118178068,0.7946925523456136,0.7237359528731523
Slough,0,25,147,172,1.1133838453668112,0.6658675626698883,0.0
Smethwick,2,41,149,192,1.0109765160523185,0.9782704274891775,0.7388137852246762
Solihull West and Shirley,0,15,84,99,1.1053507728894174,0.6941164895710351,0.0
South Basildon and East Thurrock,5,33,82,120,0.8902021403091558,1.2598214285714286,2.955255140898705
South Cambridgeshire,2,51,130,183,0.9254400499015614,1.2767191824568873,0.7751488894160539
South Cotswolds,5,45,115,165,0.9079667063020215,1.249409681227863,2.1492764661081494
South Derbyshire,2,27,108,137,1.0269734500985097,0.9028580908142952,1.0354178595849477
South Devon,1,21,95,117,1.0577761517119424,0.8222610722610723,0.6062061827484524
South Dorset,2,34,122,158,1.005909179849185,0.9858211408844321,0.897799030146442
South East Cornwall,2,36,118,156,0.9854019939632306,1.0571928071928074,0.9093092741226785
South Holland and The Deepings,4,35,173,212,1.063080788818343,0.7563250428816466,1.3382287430484703
South Leicestershire,6,30,85,121,0.9151443087233813,1.135826982934421,3.516997853631517
South Norfolk,2,26,84,112,0.97705112960761,1.063485621521336,1.2665379175280165
South Northamptonshire,5,20,126,151,1.0870502634044932,0.6067773286316334,2.348547131840031
South Ribble,1,40,80,121,0.8613122905631824,1.5144359772458946,0.5861663089385861
South Shields,0,17,75,92,1.062012097399576,0.8465203274985883,0.0
South Shropshire,9,31,64,104,0.8016829781395775,1.3655407092907093,6.13783760032808
South Suffolk,4,32,88,124,0.924521498983545,1.1822371177209887,2.287939463921578
South West Devon,2,32,82,116,0.9208987658370577,1.2637707120465742,1.222864196233947
South West Hertfordshire,4,28,106,138,1.0006513984387115,0.9295125164690383,2.0558296632338817
South West Norfolk,8,41,105,154,0.8882282996432818,1.2196618316748187,3.6844739418996846
South West Wiltshire,2,19,126,147,1.116629862408697,0.5921238625320259,0.9649812704975363
Southampton Itchen,1,35,108,144,0.97705112960761,1.1134785353535355,0.4925425234831175
Southampton Test,1,36,155,192,1.051686979785969,0.8589691558441559,0.3694068926123381
Southend East and Rochford,2,42,90,134,0.8749711608426358,1.4358887381275443,1.0585988564413271
Southend West and Leigh,1,34,117,152,1.0027630014393891,1.024735133287765,0.4666192327734797
Southgate and Wood Green,1,42,336,379,1.1549311505651958,0.5076757016071001,0.1871401672336911
Southport,2,32,95,129,0.9593783701573431,1.136413973623276,1.0996298198692855
Spelthorne,2,47,179,228,1.0227611239752175,0.944363750284803,0.6221589770313063
Spen Valley,4,34,122,160,0.9933353151010701,0.9734983766233767,1.7731530845392232
St Albans,3,36,147,186,1.0295807602316749,0.8866778382907415,1.143969731960789
St Austell and Newquay,6,33,100,139,0.9372193089761246,1.0876156217882837,3.0615592826576514
St Helens North,4,26,85,115,0.9628909683089489,1.0357425183512141,2.4669955958806584
St Helens South and Whiston,1,30,85,116,0.954590184099389,1.1847850425436635,0.6114320981169735
St Ives,4,39,86,129,0.8684898929845422,1.3850045303533676,2.199259639738571
St Neots and Mid Cambridgeshire,3,32,105,140,0.97705112960761,1.0471243042671614,1.5198455010336198
Stafford,0,10,45,55,1.0658739595719382,0.8329397874852421,0.0
Staffordshire Moorlands,2,31,37,70,0.68858841515203,2.028803339517625,2.0264606680448263
Stalybridge and Hyde,0,19,52,71,0.9541156570816097,1.2259465886226448,0.0
Stevenage,1,19,107,127,1.097579746645819,0.6853717148992741,0.5584734124532986
Stockport,1,19,44,64,0.8956302021403092,1.3600344967532467,1.1082206778370145
Stockton North,4,30,74,108,0.8926146122341129,1.2725468975468976,2.626893458576627
Stockton West,1,16,52,69,0.9817711833738303,1.062300018821758,1.0279148316169409
Stoke-on-Trent Central,1,22,79,102,1.008980905084983,0.9880952380952381,0.6953541507996953
Stoke-on-Trent North,1,12,34,47,0.9424039264300352,1.1696601271069356,1.5090664549269983
Stoke-on-Trent South,5,15,55,75,0.9553388822829963,0.9162337662337663,4.728408225437928
"Stone, Great Wyrley and Penkridge",9,30,81,120,0.8793460166468491,1.1452922077922079,5.319459253617669
Stourbridge,2,36,87,125,0.906703448275862,1.3193766233766233,1.1348179741051028
Stratford and Bow,0,29,251,280,1.1678087311024292,0.4744782003710576,0.0
Stratford-on-Avon,9,26,102,137,0.9699193695374814,0.8694189022656176,4.659380368132266
Streatham and Croydon North,3,53,382,438,1.1361751339729285,0.5543423471505663,0.4857953656271844
Stretford and Urmston,3,30,69,102,0.8812618031754914,1.3474025974025976,2.086062452399086
Stroud,1,36,76,113,0.8761756442498922,1.4594874152396278,0.6276648086864507
Suffolk Coastal,5,27,74,106,0.9094563973706055,1.1669014947316834,3.345571857621176
Sunderland Central,2,20,94,116,1.0556644388863832,0.7898566950291089,1.222864196233947
Surrey Heath,2,56,138,196,0.9172316726928583,1.3089053803339517,0.7237359528731523
Sussex Weald,1,55,136,192,0.9227705112960761,1.3123139880952381,0.3694068926123381
Sutton Coldfield,2,15,107,124,1.124134095354992,0.5541736489317135,1.143969731960789
Sutton and Cheam,1,28,122,151,1.052540731232922,0.8494882600842866,0.4697094263680061
Swansea West,1,14,61,76,1.0456161211590214,0.8438995215311005,0.9332384655469594
Swindon North,1,27,150,178,1.0978102579860785,0.6948963957390925,0.39846136731218496
Swindon South,1,13,134,148,1.1795031654722499,0.40239996489996493,0.47923056338897924
Tamworth,3,17,53,73,0.9458211848256316,1.0668475360256182,2.914772193763106
Tatton,2,31,166,199,1.0867034339354322,0.7136494159107225,0.7128253606187832
Taunton and Wellington,2,12,97,111,1.138425940804062,0.4952614952614953,1.2779481690372778
Telford,1,20,46,67,0.8944149644169166,1.3675130839309944,1.0585988564413271
Tewkesbury,3,44,99,146,0.8833612952616748,1.3806262230919766,1.457386096881553
The Wrekin,3,26,68,97,0.9132574132414774,1.2279421609318517,2.1935914447907914
Thirsk and Malton,6,40,145,191,0.9889871818017693,0.9594070850615354,2.2280457606775577
Thornbury and Yate,4,21,108,133,1.0578598696503445,0.7233424470266575,2.1331164926787647
Thurrock,0,36,124,160,1.0096195005945303,1.030762987012987,0.0
Tipton and Wednesbury,1,35,112,148,0.9858533920365075,1.083384520884521,0.47923056338897924
Tiverton and Minehead,2,20,87,109,1.0397975324264472,0.8405814369117123,1.3013967592948428
Tonbridge,1,44,143,188,0.9909100108786398,1.0721884498480243,0.3772666137317496
Tooting,1,40,317,358,1.1535389500395246,0.5118624392367409,0.19811766307700818
Torbay,2,37,110,149,0.9617505526338891,1.1376056829076964,0.9520285017660258
Torfaen,4,22,54,80,0.8793460166468491,1.2598214285714286,3.5463061690784463
Torridge and Tavistock,1,41,114,156,0.9519985365407482,1.2040251415251417,0.45465463706133924
Tottenham,0,64,367,431,1.1092892948677273,0.680266369361497,0.0
Truro and Falmouth,2,32,128,162,1.0293213546483462,0.9049222382555716,0.8756311528588756
Tunbridge Wells,3,56,151,210,0.9367283845761848,1.2216450216450216,1.0132303340224131
Twickenham,0,40,125,165,0.9869203329369798,1.1105863833136562,0.0
Tynemouth,1,20,90,111,1.0562714914676865,0.8254358254358254,0.6389740845186389
Uxbridge and South Ruislip,1,35,152,188,1.0532749765982745,0.8528771760154739,0.3772666137317496
Vale of Glamorgan,1,14,54,69,1.019531613503593,0.9295125164690383,1.0279148316169409
Vauxhall and Camberwell Green,0,64,299,363,1.073051561993298,0.8076991878644771,0.0
Wakefield and Rothwell,2,50,119,171,0.9065815549575484,1.3395230500493658,0.8295453027084084
Wallasey,0,23,91,114,1.0399023718630702,0.9242709045340625,0.0
Walsall and Bloxwich,0,36,146,182,1.0450510250748064,0.9061652633081204,0.0
Walthamstow,2,28,197,227,1.130567239545957,0.565078093712455,0.6248997654763783
Warrington North,4,35,138,177,1.0156915697615834,0.9058808423215203,1.6028502459111622
Warrington South,0,24,91,115,1.0308597425425219,0.9560700169395822,0.0
Warwick and Leamington,0,14,108,122,1.153240677569638,0.5257078986587184,0.0
Washington and Gateshead South,0,24,100,124,1.050592612481301,0.8866778382907415,0.0
Watford,2,33,127,162,1.0212797815651562,0.9332010582010581,0.8756311528588756
Waveney Valley,4,45,80,129,0.8078975748693416,1.5980821504077318,2.199259639738571
Weald of Kent,6,55,202,263,1.0005796105487312,0.9580391091797937,1.6180864649787587
Wellingborough and Rushden,2,30,86,118,0.9494508152119147,1.1647039401276689,1.2021376844333715
Wells and Mendip Hills,5,24,104,133,1.0186798744781096,0.8266770823161801,2.666395615848456
Welwyn Hatfield,4,27,116,147,1.0280084447572133,0.8414391730718263,1.9299625409950727
West Bromwich,2,38,160,200,1.0421878715814508,0.8704220779220779,0.7092612338156893
West Dorset,2,51,135,188,0.9354744857945202,1.2427638850511191,0.7545332274634992
West Ham and Beckton,0,28,194,222,1.138425940804062,0.5778050778050777,0.0
West Lancashire,5,40,99,144,0.8956302021403092,1.2725468975468976,2.462712617415588
West Suffolk,4,32,87,123,0.9214465937762826,1.1918488016048994,2.3065405977745996
West Worcestershire,4,36,90,130,0.9018933504070246,1.2686313686313688,2.1823422578944287
Westmorland and Lonsdale,7,72,132,211,0.81498103701867,1.5632424447590325,2.352999353890912
Weston-super-Mare,0,15,82,97,1.101280998320605,0.708428169768376,0.0
Wetherby and Easingwold,2,43,124,169,0.9558527816279576,1.165622838699762,0.8393624068824724
Whitehaven and Workington,4,28,89,121,0.9582099232515403,1.0601051840721263,2.3446652357543445
Widnes and Halewood,0,18,87,105,1.0794088669950739,0.7853432282003711,0.0
Wigan,0,25,49,74,0.862621718031944,1.5476921726921726,0.0
Wimbledon,1,36,160,197,1.058058752874569,0.8371679082338981,0.3600310831551722
Winchester,6,53,161,220,0.9533650416171224,1.1036452184179457,1.9343488194973342
Windsor,1,35,142,178,1.0392603775601543,0.9007916241062309,0.39846136731218496
Wirral West,2,23,60,85,0.9195775337483388,1.2396103896103896,1.6688499619192687
Witham,2,47,127,176,0.9400416171224732,1.223380312868949,0.805978674790556
Witney,1,19,65,85,0.9962089948940336,1.024025974025974,0.8344249809596344
Woking,2,44,141,187,0.9822760019584529,1.077922077922078,0.7585681645087585
Wokingham,2,20,66,88,0.97705112960761,1.0411747343565525,1.611957349581112
Wolverhampton North East,0,18,125,143,1.1387542303118998,0.5766506221051676,0.0
Wolverhampton South East,3,39,164,206,1.037128707156298,0.8673086622115749,1.032904709440324
Wolverhampton West,2,23,128,153,1.0898696696276609,0.6886724386724387,0.9271388677329272
Worcester,1,16,55,72,0.9951446690447879,1.018037518037518,0.985085046966235
Worsley and Eccles,1,30,83,114,0.9484823831278554,1.2055707450444293,0.6221589770313063
Worthing West,0,34,120,154,1.0151180567351792,1.0114268848035082,0.0
Wrexham,5,22,65,92,0.9204104844129659,1.095496894409938,3.8546806185635285
Wycombe,1,19,99,119,1.0837878076319707,0.7314471243042672,0.596017843542596
Wyre Forest,3,23,62,88,0.9178359096313913,1.1973509445100354,2.417936024371668
Wythenshawe and Sale East,3,24,69,96,0.9363406658739596,1.1452922077922079,2.216441355674029
Yeovil,3,22,87,112,1.0119458128078818,0.8998724489795918,1.8998068762920246
Ynys Môn,1,13,35,49,0.930524885340581,1.2154121388815267,1.4474719057463046
York Central,1,31,161,193,1.0867373531386888,0.7358354081152009,0.3674928672620152
York Outer,3,25,87,115,0.9855472263868066,0.9959062676453981,1.8502466969104936
